gr gr gr gr gr gr gr gr gr gr gr gr gr gr gr gr gr gr gr gr gr
gr gr gr gr gr gr gr gr gr gr gr gr gr gr gr gr gr gr gr gr gr
gr gr gr gr gr gr gr gr gr gr gr gr gr gr gr gr gr gr gr gr gr
gr gr gr gr gr gr gr gr gr gr gr gr gr gr gr gr gr gr gr gr gr
wa wa wa wa wa wa wa wa wa wa wa wa wa wb wa wa wa wa wa wa wa
gr gr gr gr gr gr gr gr gr gr gr gr gr gr gr gr gr gr gr gr gr
gr dr dr dr dr dr dr dr dr dr dr dr dr dr dr dr dr dr dr dr dr
gr dr dr dr dr dr dr dr dr dr dr dr dr dr dr dr dr dr dr dr dr
gr dr dr dr dr dr dr dr dr dr dr dr dr dr dr dr dr dr dr dr dr
gr dr dr dr dr dr dr dr dr dr dr dr dr dr dr dr dr dr dr dr dr
gr dr dr dr dr dr dr dr dr dr dr dr dr dr dr dr dr dr dr dr dr
gr dr dr dr dr dr dr dr dr dr dr dr dr dr dr dr dr dr dr dr dr
gr dr dr dr dr dr dr dr dr dr dr dr dr dr dr dr dr dr dr dr dr
gr dr dr dr dr dr dr dr dr dr dr dr dr dr dr dr dr dr dr dr dr
gr dr dr dr dr dr dr dr dr dr dr dr dr dr dr dr dr dr dr dr dr
gr dr dr dr dr dr dr dr dr dr dr dr dr dr dr dr dr dr dr dr dr
gr dr dr dr dr dr dr dr dr dr dr dr dr dr dr dr dr dr dr dr dr
gr dr dr dr dr dr dr dr dr dr dr dr dr dr dr dr dr dr dr dr dr
gr dr dr dr dr dr dr dr dr dr dr dr dr dr dr dr dr dr dr dr dr
gr dr dr dr dr dr dr dr dr dr dr dr dr dr dr dr dr dr dr dr dr
gr dr dr dr dr dr dr dr dr dr dr dr dr dr dr dr dr dr dr dr dr
gr dr dr dr dr dr dr dr dr dr dr dr dr dr dr dr dr dr dr dr dr
gr dr dr dr dr dr dr dr dr dr dr dr dr dr dr dr dr dr dr dr dr
gr dr dr dr dr dr dr dr dr dr dr dr dr dr dr dr dr dr dr dr dr
gr dr dr dr dr dr dr dr dr dr dr dr dr dr dr dr dr dr dr dr dr
gr dr dr dr dr dr dr dr dr dr dr dr dr dr dr dr dr dr dr dr dr
gr dr dr dr dr dr dr dr dr dr dr dr dr dr dr dr dr dr dr dr dr
gr dr dr dr dr dr dr dr dr dr dr dr dr dr dr dr dr dr dr dr dr
gr dr dr dr dr dr dr dr dr dr dr dr dr dr dr dr dr dr dr dr dr
gr dr dr dr dr dr dr dr dr dr dr dr dr dr dr dr dr dr dr dr dr
gr dr dr dr dr dr dr dr dr dr dr dr dr dr dr dr dr dr dr dr dr