bl bl bl bl bl bl bl bl bl bl bl bl bl bl bl
bl bl bl bl bl bl bl bl bl bl bl bl bl bl bl
gr gr gr gr gr gr bdl bd bdr gr gr gr gr gr gr
gr gr gr gr gr gr gr gr gr gr gr gr gr gr gr
dr dr dr dr dr dr gr gr gr dr dr dr dr dr dr
dr dr dr dr dr dr gr gr gr dr dr dr dr dr dr
dr dr dr dr dr dr gr gr gr dr dr dr dr dr dr
dr dr dr dr dr dr gr gr gr dr dr dr dr dr dr
dr dr dr dr dr dr gr gr gr dr dr dr dr dr dr
dr dr dr dr dr dr gr gr gr dr dr dr dr dr dr
dr dr dr dr dr dr gr gr gr dr dr dr dr dr dr
dr dr dr dr dr dr gr gr gr dr dr dr dr dr dr
dr dr dr dr dr dr gr gr gr dr dr dr dr dr dr
dr dr dr dr dr dr gr gr gr dr dr dr dr dr dr
gr gr gr gr gr gr gr gr gr gr gr gr gr gr gr
gr gr gr gr gr gr gr gr gr gr gr gr gr gr gr