gr gr gr gr gr gr gr gr gr gr gr gr gr
gr gr gr gr gr gr gr gr gr gr gr gr gr
gr gr gr gr gr gr gr gr gr gr gr gr gr
gr gr gr gr gr gr gr gr gr gr gr gr gr
gr gr gr gr gr gr gr gr gr gr gr gr gr
gr gr gr gr gr gr gr gr gr gr gr gr gr
gr gr gr gr gr gr gr gr gr gr gr gr gr
dr gr gr gr gr ga ga gr gr gr gr gr dr
dr gr gr gr gr gr ga gr gr gr gr gr dr
dr gr gr gr gr gr ga gr gr gr gr gr dr
dr gr gr gr gr gr gr gr gr gr gr gr dr
dr gr gr gr gr gr ga gr gr gr gr gr dr
gr gr gr gr gr gr gr ga gr gr gr gr gr
gr gr gr gr gr gr gr gr gr gr gr gr gr
gr gr gr gr gr gr gr gr gr gr gr gr gr
gr gr gr gr gr gr gr gr gr gr gr gr gr
gr gr gr gr gr gr gr gr gr gr gr gr gr