oc oc oc oc oc oc oc oc oc oc oc oc oc oc oc oc oc oc oc oc oc oc oc oc oc oc oc
oc oc oc oc oc oc oc oc oc oc oc oc oc oc oc oc oc oc oc oc oc oc oc oc oc oc oc
oc oc oc oc oc oc oc oc oc oc oc oc oc oc oc oc oc oc oc oc oc oc oc oc oc oc oc
oc oc oc oc oc oc oc oc oc oc oc oc oc oc oc oc oc oc oc oc oc oc oc oc oc oc oc
oc oc oc oc oc oc oc oc oc oc oc oc oc oc oc oc oc oc oc oc oc oc oc oc oc oc oc
oc oc oc oc oc oc D-anderz-True-103 oc pl pl pl pl pl pl pl pl pl oc oc oc oc oc oc oc oc oc oc
oc oc oc oc oc oc oc oc pl oc oc oc oc oc oc oc pl oc oc oc oc oc oc oc oc oc oc
oc oc oc oc oc oc oc oc pl oc oc oc oc oc oc oc pl oc oc oc oc oc oc oc oc oc oc
oc oc oc oc oc oc oc oc pl oc oc oc oc oc oc oc pl oc oc oc oc oc oc oc oc oc oc
oc oc oc oc oc oc oc oc pl oc oc oc oc oc oc oc pl oc oc oc oc D-othersidead-True-22 none-rail-True none-rail-True none-rail-True none-rail-True none-rail-True none-rail-True none-rail-True oc oc
oc oc oc oc oc oc oc oc pl oc oc oc oc oc oc oc pl oc oc oc oc oc oc oc oc oc oc
oc oc oc oc oc oc oc oc pl oc oc oc oc oc oc oc pl oc oc oc oc oc oc oc oc oc oc
oc oc oc oc oc oc oc oc pl mw mw mw id mw mw mw pl oc oc oc oc oc oc oc oc oc oc
oc oc oc oc oc oc oc oc pl pl pl pl pl pl pl pl pl oc oc oc oc oc oc oc oc oc oc
oc oc oc oc oc oc oc oc oc oc oc oc oc oc oc oc oc oc oc oc oc oc oc oc oc oc oc
oc oc oc oc oc oc oc oc oc oc oc oc oc oc oc oc oc oc oc oc oc oc oc oc oc oc oc
oc oc oc oc oc oc oc oc oc oc oc oc oc oc oc oc oc oc oc oc oc oc oc oc oc oc oc
oc oc oc oc oc oc oc oc oc oc oc oc oc oc oc oc oc oc oc oc oc oc oc oc oc oc oc
oc oc oc oc oc oc oc oc oc oc oc oc oc oc oc oc oc oc oc oc oc oc oc oc oc oc oc
oc oc oc oc oc oc oc oc oc oc oc oc oc oc oc oc oc oc oc oc oc oc oc oc oc oc oc