oc oc oc oc oc oc oc oc oc oc oc oc oc oc oc oc oc oc oc oc oc oc oc oc oc oc oc oc oc oc oc
oc oc oc oc oc oc oc oc oc oc oc oc oc oc oc oc oc oc oc oc oc oc oc oc oc oc oc oc oc oc oc
oc oc oc oc oc oc oc oc oc oc oc oc oc oc oc oc oc oc oc oc oc oc oc oc oc oc oc oc oc oc oc
oc oc oc oc oc oc oc oc oc oc oc oc oc oc oc oc oc oc oc oc oc oc oc oc oc oc oc oc oc oc oc
oc oc oc oc oc oc pl pl pl pl pl pa pa pa pa pa pa pa pa pa pa pa oc oc oc oc oc oc oc oc oc
oc oc oc oc oc oc pl pl pl pl pl pa pa pa pa pa pa pa pa pa pa pa oc oc oc oc oc oc oc oc oc
oc oc oc oc oc oc pl pl pl pl pl pa pa bl bl bl bl bl bl bl pa pa oc oc oc oc oc oc oc oc oc
oc oc oc oc oc oc oc oc oc oc oc pa pa bl bl bl bl bl bl bl pa pa oc oc oc oc oc oc oc oc oc
oc oc oc oc oc oc oc oc oc oc oc pa pa bl bl bl bl bl bl bl pa pa oc oc oc oc oc oc oc oc oc
oc oc oc oc oc oc oc oc oc oc oc pa pa bl bl bl bl bl bl bl pa pa pl pl pl pl pl pl pl pl pl
oc oc oc oc oc oc oc oc oc oc oc pa pa bl bl bl bl bl bl bl pa pa oc oc oc oc oc oc oc oc oc
oc oc oc oc oc oc oc oc oc oc oc pa pa bl bl bl bl bl bl bl pa pa oc oc oc oc oc oc oc oc oc
oc oc oc oc oc oc pl pl pl pl pl pa pa mw mw mw id mw mw mw pa pa oc oc oc oc oc oc oc oc oc
oc oc oc oc oc oc pl pl pl pl pl pa pa pa pa pa pa pa pa pa pa pa oc oc oc oc oc oc oc oc oc
oc oc oc oc oc oc pl pl pl pl pl pa pa pa pa pa pa pa pa pa pa pa oc oc oc oc oc oc oc oc oc
oc oc oc oc oc oc oc oc oc oc oc oc oc oc oc oc oc oc oc oc oc oc oc oc oc oc oc oc oc oc oc
oc oc oc oc oc oc oc oc oc oc oc oc oc oc oc oc oc oc oc oc oc oc oc oc oc oc oc oc oc oc oc
oc oc oc oc oc oc oc oc oc oc oc oc oc oc oc oc oc oc oc oc oc oc oc oc oc oc oc oc oc oc oc
oc oc oc oc oc oc oc oc oc oc oc oc oc oc oc oc oc oc oc oc oc oc oc oc oc oc oc oc oc oc oc
oc oc oc oc oc oc oc oc oc oc oc oc oc oc oc oc oc oc oc oc oc oc oc oc oc oc oc oc oc oc oc
oc oc oc oc oc oc oc oc oc oc oc oc oc oc oc oc oc oc oc oc oc oc oc oc oc oc oc oc oc oc oc