tr tr tr gr gr gr tr tr
tr gr gr gr gr gr gr gr
gr gr gr gr gr gr gr gr
gr gr gr gr gr gr gr gr
tr gr gr gr gr gr gr tr
tr gr gr gr gr gr gr tr
tr tr tr gr gr gr tr tr
tr gr tr gr gr gr gr tr
tr gr gr gr gr gr gr tr
tr gr gr gr gr gr tr tr
tr gr gr gr gr gr tr tr
tr tr gr gr gr gr tr tr
gr gr gr gr gr gr gr gr