sn sn sy sn sn ie sy sn sn sn sy
ie ie sy ie ie ie sy ie ie ie sy
sy ie sn ie sy sn sn sn sn ie sy
sy ie ie ie sy ie ie ie ie ie sy
sy ie sy ie sn sn sy ie sn sn sy
sy ie sy ie ie ie sy ie ie ie sy
sy ie sy ie sn sn sn sn sn ie sy
sy ie sy ie ie ie ie ie ie ie sy
sy sn sn sn sn ie sn sn sy ie sn
sy ie ie ie ie ie ie ie sy ie ie
sy sy sy sy sy ie sy sy sy sy sy